ISEL: POO 19-20SV
Levels description
. - Space
@ - Hero
X - Wall
* - Virus
V - Trash can

#1 9 x 9
@........
XX.......
.......XX
.........
..*......
.XXXX.X..
.........
.*.......
XXXXXVXXX

#2 9 x 9
......@..
XX.XXXX..
...*.....
..XX..XX.
..*....*.
.XX..XX..
......*..
.........
VXXVXXVXX
